10,9,3,3,4,5,6,3,10,8
10,9,3,4,7,8,13,5,7,8
10,9,3,10,8,8,8,8,8,8
10,9,3,11,12,8,2,14,12,8
10,13,5,5,7,8,9,3,11,14
11,14,14,14,12,8,9,3,3,3
3,3,4,5,7,8,13,5,6,3
3,3,10,8,8,8,8,8,9,3
3,3,11,14,14,14,14,14,15,3
3,3,3,3,3,3,3,3,3,3
