9,9,9,9,9,9,9,9,9,9,9,9,9,9,9,9,9,9,9,9,9,9,9,9,9,9,9,9,9,9,9,9,9,9,9,9,9,9,9,9,9,9,9,9,9,9,9,9,9,9
9,9,9,9,9,9,9,9,9,9,9,9,9,9,9,9,9,9,9,9,9,9,9,9,9,9,9,9,9,9,9,9,9,9,9,9,9,9,9,9,9,9,9,9,9,9,9,9,9,9
9,9,9,1,2,3,9,9,9,9,9,9,9,9,9,9,9,9,9,9,9,9,9,9,9,9,9,9,9,9,9,9,9,1,2,2,2,3,9,9,9,9,9,9,9,9,9,9,9,9
9,9,9,8,0,4,9,9,9,9,9,9,9,9,9,9,9,9,1,2,3,9,9,9,9,9,9,9,9,9,9,9,1,0,0,0,0,0,3,9,9,9,9,9,9,9,9,9,9,9
9,9,9,7,6,5,9,9,9,9,9,9,9,9,9,9,9,9,8,0,0,3,9,9,9,9,9,9,9,9,9,1,0,0,0,0,0,0,4,9,9,9,9,9,9,9,9,9,9,9
9,9,9,9,9,9,9,9,9,9,9,9,9,9,9,9,9,9,8,0,0,0,2,3,9,9,9,9,9,9,9,8,0,0,0,0,0,0,0,3,9,9,9,9,9,9,9,9,9,9
9,9,9,9,9,9,9,9,9,9,9,9,9,9,9,9,9,9,7,0,0,0,0,0,3,9,9,9,9,9,9,7,0,0,0,0,0,0,0,0,2,3,9,9,9,9,9,9,9,9
9,9,9,9,9,9,9,9,9,9,9,9,9,9,9,9,9,9,9,7,0,0,0,0,0,2,2,3,9,9,9,9,7,6,0,0,0,0,0,0,0,0,3,9,9,9,9,9,9,9
9,9,9,9,9,9,9,9,9,9,9,9,9,9,9,9,9,9,9,9,7,0,0,0,0,0,0,0,3,9,9,9,9,9,7,6,0,0,0,0,0,0,4,9,9,9,9,9,9,9
9,9,9,9,9,9,9,9,9,9,9,9,9,9,9,9,9,9,9,9,9,7,0,0,0,0,0,0,5,9,9,9,9,9,9,9,7,0,0,0,0,0,5,9,9,9,9,9,9,9
9,9,9,9,9,9,9,1,2,2,3,9,9,9,9,9,9,9,9,9,9,9,7,0,0,0,0,5,9,9,9,9,9,9,9,9,9,8,0,0,0,5,9,9,9,9,9,9,9,9
9,9,9,9,9,9,1,0,0,0,0,3,9,9,9,9,9,9,9,9,9,9,9,8,0,0,4,9,9,9,9,9,9,9,9,9,9,8,0,0,4,9,9,9,9,9,9,9,9,9
9,9,9,9,9,1,0,0,0,0,0,4,9,9,9,9,9,9,9,9,9,9,9,7,6,6,5,9,9,9,9,9,9,9,9,9,1,0,0,0,4,9,9,9,9,9,9,9,9,9
9,9,9,9,9,8,0,0,0,0,0,5,9,9,9,9,9,9,9,9,9,9,9,9,9,9,9,9,9,9,9,9,9,9,9,9,8,0,0,0,4,9,9,9,9,9,9,9,9,9
9,9,9,9,9,7,6,0,0,0,5,9,9,9,9,9,9,9,9,9,9,9,9,9,9,9,9,9,9,9,9,9,9,9,9,9,8,0,0,0,5,9,9,9,9,9,9,9,9,9
9,9,9,9,9,9,9,9,7,5,9,9,9,9,9,9,9,9,9,9,9,9,9,9,9,9,9,9,9,9,9,9,9,9,9,9,8,0,0,5,9,9,9,9,9,9,9,9,9,9
9,9,9,9,9,9,9,9,9,9,9,9,9,9,9,9,9,9,9,9,9,9,9,9,9,9,9,9,9,9,1,3,9,9,9,9,7,6,5,9,9,9,9,9,9,9,1,2,3,9
9,9,9,9,9,9,9,9,9,9,9,9,9,9,9,9,9,9,9,9,9,9,9,9,9,9,9,9,9,1,0,0,3,9,9,9,9,9,9,9,9,9,9,9,9,1,0,0,4,9
9,9,9,9,9,9,9,9,9,9,9,9,9,9,9,9,9,9,9,9,9,1,2,2,3,9,9,9,1,0,0,0,4,9,9,9,9,9,9,9,9,9,9,1,2,0,0,0,4,9
9,9,9,9,9,9,9,9,9,9,9,9,9,9,9,9,9,9,1,2,2,0,0,0,4,9,9,1,0,0,0,0,4,9,9,9,9,9,9,9,9,1,2,0,0,0,0,0,4,9
9,9,1,2,3,9,9,9,9,9,9,9,9,9,9,9,9,9,7,0,0,0,0,0,0,2,2,0,0,0,0,0,4,9,9,9,9,9,1,2,2,0,0,0,0,0,0,0,5,9
9,9,8,0,0,3,9,9,9,9,9,9,9,9,9,9,9,9,9,7,0,0,0,0,0,0,0,0,0,0,0,0,4,9,9,9,9,1,0,0,0,0,0,0,0,0,0,4,9,9
9,9,8,0,0,0,3,9,9,9,9,9,9,9,9,9,9,9,9,9,7,0,0,0,0,0,0,0,0,0,0,0,4,9,9,9,1,0,0,0,0,0,0,0,0,0,0,0,3,9
9,9,7,0,0,6,5,9,9,9,9,9,9,9,9,9,9,9,9,9,9,7,0,0,0,0,0,0,0,0,0,0,5,9,9,1,0,0,0,0,0,0,0,0,0,0,0,0,4,9
9,9,9,7,5,9,9,9,9,9,9,9,9,9,9,9,9,9,9,9,9,9,8,0,0,0,0,0,0,0,0,5,9,9,9,8,0,0,0,0,0,0,0,0,0,0,0,0,4,9
9,9,9,9,9,9,9,9,9,9,9,9,9,9,9,9,9,9,9,9,9,9,7,0,0,0,0,0,0,0,4,9,9,9,9,8,0,0,0,0,0,0,0,0,0,0,0,0,4,9
9,9,9,9,9,9,9,9,9,9,9,9,9,9,9,9,9,9,9,9,9,9,9,7,0,0,0,0,0,0,4,9,9,9,9,8,0,0,0,0,0,0,0,0,0,0,0,0,5,9
9,9,9,9,9,9,9,9,1,2,2,2,2,3,9,9,9,9,9,9,9,9,9,9,7,6,6,6,0,0,4,9,9,9,9,7,0,0,0,0,0,0,0,0,0,0,0,4,9,9
9,9,9,9,9,9,9,1,0,0,0,0,0,0,3,9,9,9,9,9,9,9,9,9,9,9,9,9,7,6,5,9,9,9,9,9,7,0,0,0,0,0,0,0,0,0,6,5,9,9
9,9,9,9,9,9,9,8,0,0,0,0,0,0,0,3,9,9,9,9,9,9,9,9,9,9,9,9,9,9,9,9,9,9,9,9,9,7,0,0,0,0,0,0,6,5,9,9,9,9
9,9,9,9,9,9,9,8,0,0,0,0,0,0,0,4,9,9,9,9,9,9,9,9,9,9,9,9,9,9,9,9,9,9,9,9,9,9,7,6,6,6,6,5,9,9,9,9,9,9
9,9,9,9,9,9,9,8,0,0,0,0,0,0,0,0,3,9,9,9,9,9,9,9,9,9,9,9,9,9,9,9,9,9,9,9,9,9,9,9,9,9,9,9,9,9,9,9,9,9
9,9,9,9,9,9,9,8,0,0,0,0,0,0,0,0,4,9,9,9,9,9,9,9,9,9,9,9,9,9,9,9,9,9,9,9,9,9,9,9,9,9,9,9,9,9,9,9,9,9
9,9,9,9,9,9,1,0,0,0,0,0,0,0,0,0,4,9,9,9,9,9,9,9,9,9,9,9,9,9,9,9,9,9,9,9,9,9,9,9,9,9,9,9,9,9,9,9,9,9
9,9,9,9,9,1,0,0,0,0,0,0,0,0,0,0,0,3,9,9,9,9,9,9,9,9,9,9,9,9,9,9,9,9,9,9,9,9,9,9,9,9,9,9,9,9,9,9,9,9
9,9,9,9,9,7,0,0,0,0,0,0,0,0,0,0,0,0,3,9,9,9,9,9,9,9,9,9,9,9,9,9,9,9,9,9,9,9,9,9,9,9,9,9,9,9,9,9,9,9
9,9,9,9,9,9,8,0,0,0,0,0,0,0,0,0,0,0,0,3,9,9,9,9,9,9,9,9,9,9,9,9,9,9,9,9,9,9,9,9,9,9,9,9,9,9,9,9,9,9
9,9,9,9,9,9,8,0,0,0,0,0,0,0,0,0,0,0,0,0,3,9,9,9,9,9,9,9,9,9,9,9,9,9,9,9,9,9,9,9,9,9,9,9,9,9,9,9,9,9
9,9,9,9,9,9,8,0,0,0,0,0,0,0,0,0,0,0,0,0,0,3,9,9,9,9,9,9,9,9,9,9,9,9,9,9,9,9,9,9,9,9,9,9,9,9,9,9,9,9
9,9,9,9,9,9,8,0,0,0,0,0,0,0,0,0,0,0,0,0,0,0,2,2,2,2,2,2,2,2,3,9,9,9,9,9,9,9,9,9,9,9,9,9,9,9,9,9,9,9
9,9,9,9,9,9,7,0,0,0,0,0,0,0,0,0,0,0,0,0,0,0,0,0,0,0,0,0,0,0,0,2,2,2,2,2,3,9,9,9,9,9,9,9,9,9,9,9,9,9
9,9,9,9,9,9,9,7,6,6,0,0,0,0,0,0,0,0,0,0,0,0,0,0,0,0,0,0,0,0,0,0,0,0,0,0,0,3,9,9,9,9,9,9,9,9,9,9,9,9
9,9,9,9,9,9,9,9,9,9,7,0,0,0,0,0,0,0,0,0,0,0,0,0,0,0,0,0,0,0,0,0,0,0,0,0,0,0,2,3,9,9,9,9,9,9,9,9,9,9
9,9,9,9,9,9,9,9,9,9,9,7,0,0,0,0,0,0,0,0,0,0,0,0,0,0,0,0,0,0,0,0,0,0,0,0,0,0,0,0,3,9,9,9,9,9,9,9,9,9
9,9,9,9,9,9,9,9,9,9,9,9,7,0,0,0,0,0,0,0,0,0,0,0,0,0,0,0,0,0,0,0,0,0,0,0,0,0,0,0,0,2,3,9,9,9,9,9,9,9
2,2,2,3,9,9,9,9,9,9,9,9,9,0,0,0,0,0,0,0,0,0,0,0,0,0,0,0,0,0,0,0,0,0,0,0,0,0,0,0,0,0,4,9,9,9,9,9,9,9
0,0,0,4,9,9,9,9,9,9,9,9,9,7,6,6,6,6,6,6,6,6,6,6,0,0,0,0,0,0,0,0,0,0,0,0,0,0,0,0,0,0,0,3,9,9,9,9,9,9
0,0,0,0,3,9,9,9,9,9,9,9,9,9,9,9,9,9,9,9,9,9,9,9,7,6,6,6,6,6,6,0,0,0,0,0,0,0,0,0,0,0,0,4,9,9,9,9,9,9
0,0,0,0,4,9,9,9,9,9,9,9,9,9,9,9,9,9,9,9,9,9,9,9,9,9,9,9,9,9,9,7,6,6,6,6,6,6,6,0,0,0,0,4,9,9,9,9,9,9
0,0,0,0,0,3,9,9,9,9,9,9,9,9,9,9,9,9,9,9,9,9,9,9,9,9,9,9,9,9,9,9,9,9,9,9,9,9,9,7,6,6,0,9,9,9,9,9,9,9
